{
  "build_version": "V33_1",
  "lineage": [
    "V28",
    "V28_1",
    "V28_2",
    "V28_3",
    "V28_4",
    "V28_5",
    "V28_6",
    "V28_7",
    "V28_8",
    "V28_9",
    "V30",
    "V30_3",
    "V30_4",
    "V30_5",
    "V30_6",
    "V30_7",
    "V30_8",
    "V30_9",
    "V31",
    "V31_1",
    "V31_3",
    "V31_4",
    "V31_5",
    "V31_6",
    "V31_7",
    "V31_8",
    "V32",
    "V32_0",
    "V32_1",
    "V32_3",
    "V32_4",
    "V32_5",
    "V32_6",
    "V32_7",
    "V32_8",
    "V33_1"
  ]
}